....................
....................
....................
....................
....................
....................
..........G.........
.........GAG........
........#####.......
....................
....GGG.......GGG...
....###.......###...
....................
.1.Q..............X.
########.....#######
