....................
....................
....................
....................
....................
....................
....................
.........A2.........
........#####.......
....................
....GGG.......GGG...
....###.......###...
....................
.S................1.
########.....#######
