....................
....................
..........0.........
.......######.......
..G..............G..
####..G.G.G.G....###
.......GKG.GBG......
......--------......
...--...........--..
....................
.G.G............G.G.
####............####
....................
.S.............Q....
####################
