....................
...G............X...
...--..G.......--...
....G.--........G...
...--..........--...
...G......G....G....
...--....--....--...
....G.....C.....G...
...--...####.G.--...
...G........--.G....
...--..........--...
....G...........G...
...--..........--...
.1..................
####################
