....................
...G............0...
...--..........--...
....G...........G...
...--....--....--...
...G...........G....
...--..........--...
....G...C.X.....G...
...--...####...--...
...G...........G....
...--..........--...
....G...........G...
...--..........--...
.S..................
####################
